********************
**  j    **    t   *
** ***** ** * * ** *
** t      t   * ** *
**** ** *** *     t*
*  t          * * **
* ** ** ** **   t **
* ** ** **  ** *****
* t    t **      t *
* *** **  * *** ** *
* *** *** * *** ** *
*    t  *t     t   *
*** *** * **** * ***
***    t         *ts
**  * ** ** ** *** *
** **    t      t  *
*   t  * *** * * * *
* ** * *   *   t * *
*   t  ***   ***  t*
********************
















